##################
#...PPPPPPPPPPPP.#
#...P..........PS#
#SPPPP...........#
#....PP..#########
#.....P..#
#.PPPPP..#
#.P......#
#.PPPPPPB#
##########